1111111111111111
1P10000000000E11
1100000000000011
1001C11110000001
101C100000110011
1111111111111111