11111111111111111111111111111
1P000000000000000000000000001
10C00C0CCCC000000000000000001
10C00C0C00C000000000000000001
10C00C0C00C000000000000000001
10C00C0C00C000000000000000001
10CCCC0CCCC000000000000000001
10C00C0C00C000000000000000001
10C00C0C00C000000000000000001
10C00C0C00C000000000000000001
10C00C0C00C000000000000000001
10000000000000000000000000E01
11111111111111111111111111111