012345678
111111111
1A0000011
11111111X