111111110
111111111
1A0000011
111111111