111111111
11111111
000000011
111111