1111111111111
1000000000001
10PE00C000C01
1000000000001
1111111111111